#####T##~#
#~~##T##~#
#~~##T##~#
########~#
+++++++#~######
+++++++#~#####
########~#
~~~~~~~~~#
