########################++~~~~~~~~~~~~~~~~~~~~~~~~~~~~~~~
########################++~~~~~~~~~~~~~~~~~~~~~~~~~~~~~~~
########################++~~~~~~~~~~~~~~~~~~~~~~~~~~~~~~~
########################++~~~~~~~~~~~~~~~~~~~~~~~~~~~~~~~
########################++~~~~~~~~~~~~~~~~~~~~~~~~~~~~~~~
########################++~~~~~~~~~~~~~~~~~~~~~~~~~~~~~~~
########################++~~~~~~~~~~~~~~~~~~~~~~~~~~~~~~~
########################++~~~~~~~~~~~~~~~~~~~~~~~~~~~~~~~
########################++~~~~~~~~~~~~~~~~~~~~~~~~~~~~~~~
########################++~~~~~~~~~~~~~~~~~~~~~~~~~~~~~~~
########################++~~~~~~~~~~~~~~~~~~~~~~~~~~~~~~~
########################++~~~~~~~~~~~~~~~~~~~~~~~~~~~~~~~
++++++++++++++++++++++++++~~~~~~~~~~~~~~~~~~~~~~~~~~~~~~~
++++++++++++++++++++++++++~~~~~~~~~~~~~~~~~~~~~~~~~~~~~~~
++++++++++++++++++++++++++~~~~~~~~~~~~~~~~~~~~~~~~~~~~~~~
++++++++++++++++++++++++++~~~~~~~~~~~~~~~~~~~~~~~~~~~~~~~
#########################+~~~~~~~~~~~~~~~~~~~~~~~~~~~~~~~
#########################+~~~~~~~~~~~~~~~~~~~~~~~~~~~~~~~
########################++~~~~~~~~~~~~~~~~~~~~~~~~~~~~~~~
########################+~~~~~~~~~~~~~~~~~~~~~~~~~~~~~~~~
########################+~~~~~~~~~~~~~~~~~~~~~~~~~~~~~~~~
########################+~~~~~~~~~~~~~~~~~~~~~~~~~~~~~~~~
########################+~~~~~~~~~~~~~~~~~~~~~~~~~~~~~~~~
########################+~~~~~~~~~~~~~~~~~~~~~~~~~~~~~~~~
